The connection matrix is
0	0	0	0	0	0	0	0	0	0	0	
0	0	0	0	0	0	0	0	0	0	0	
0	0	0	1	0	0	1	0	0	0	0	
0	0	1	0	1	1	0	0	0	0	0	
0	0	0	1	0	0	1	0	0	0	0	
0	0	0	1	0	0	1	0	0	0	0	
0	0	1	0	1	1	0	1	1	1	0	
0	0	0	0	0	0	1	0	0	0	1	
0	0	0	0	0	0	1	0	0	0	1	
0	0	0	0	0	0	1	0	0	0	1	
0	0	0	0	0	0	0	1	1	1	0	
message for 2 is 1000
 3 has no message
message for 2 is2000
message for 4 is2000
 2 has no message
-------------------------------------------------------------------------------------------------